12110113
32101301
02000103
02000000
02000000
